1
1
1
1
1
1
1
1
1
1
1
1
1
1
1
1
1
1
1
1
1
1
1
1
515
512
512
768
512
512
768
512
512
512
512
512
512
512
512
512
512
512
1
1
1
1
1
1
1
1
1
512
512
512
512
1
1
1
1
1
1
1
512
768
512
1
6658
1
1
1
512
512
512
1
1
1
1
1
1
1
1
512
512
512
1
3077
1
1
1
512
1
1
1
512
1
3593
768
512
512
3593
512
512
512
3077
6664
768
512
512
512
1
1
512
512
512
1
1
512
1
1
1
1
1
1
1
1
1
1
1
1
1
1
1
1
1
768
768
768
1
1
512
512
2564
2564
2564
2564
1
2564
2564
2564
512
768
2564
2564
3077
512
6663
1
512
512
512
1
1
1
1
2564
2564
2564
2564
2564
2564
2564
2564
1
1
1
1
1
1
1
1
1
6663
1
1
1
1
1
1
1
1
1
1
1
1
1
1
1
1
1
1
1
1
1
1
1
1
1
