1
1
1
1
1
1
1
1
1
1
1
1
1
1
1
1
1
1
1
1
1
1
1
1
1
512
512
6664
512
768
3077
3593
768
512
1
1
1
1
3077
512
512
768
6658
768
6663
1
1
1
512
768
768
768
2564
1
768
512
768
512
768
512
512
6664
768
512
768
512
512
768
1
1
2564
2564
2564
2564
2564
2564
1
512
768
512
768
768
768
768
768
512
512
768
768
768
6664
1
1
1
768
768
768
1
3593
1
768
768
768
512
768
512
512
512
1
3593
512
512
768
512
1
1
3077
768
512
6664
512
512
1
512
3077
768
512
512
768
768
768
512
768
768
512
768
512
1
1
768
768
768
768
768
512
1
1
1
1
3077
3077
512
512
512
768
6664
512
512
768
512
1
1
515
2564
2564
2564
2564
2564
2564
6663
512
512
512
512
1
512
512
1
512
6664
768
512
3077
1
1
1
1
1
1
1
1
1
1
1
1
1
1
1
1
1
1
1
1
1
1
1
1
