1
1
1
1
1
1
1
1
1
1
1
1
1
1
1
1
1
1
1
1
1
1
1
1
768
512
6664
512
768
3593
3077
3077
768
512
1
1
1
2564
3593
3077
768
3077
3077
512
512
1
1
512
512
3077
6664
768
768
768
512
768
512
1
1
1
2564
1
1
3077
6664
768
6664
768
1
1
512
768
512
768
512
512
768
3593
768
512
1
3077
768
2564
1
1
6664
512
512
2564
6664
1
1
2564
2564
2564
768
512
512
1
512
768
515
1
6658
1
768
1
1
3077
768
768
3077
768
1
1
6664
768
768
1
768
768
1
1
768
768
768
768
3077
3077
768
6664
768
2564
2564
2564
2564
1
1
3077
768
6664
512
512
768
512
512
512
6664
3593
768
768
1
512
3077
2564
2564
2564
2564
768
1
1
512
768
512
512
768
512
768
3077
768
768
512
512
512
768
512
512
2564
2564
2564
3077
2564
1
1
1
1
1
1
1
1
1
1
1
1
1
1
1
1
1
1
1
1
1
1
1
1
