1
1
1
1
1
1
1
1
1
1
1
1
1
1
1
1
1
1
1
1
1
1
1
1
1
1
1
512
512
512
512
512
1
1
512
768
512
6664
512
768
512
512
768
512
512
1
1
1
1
1
512
512
768
512
768
512
1
512
768
768
512
512
768
512
768
768
512
512
1
1
1
1
1
768
768
512
768
512
512
512
512
768
512
768
768
1
768
768
512
512
512
1
1
515
512
768
512
768
512
1
1
1
1
1
1
1
512
512
768
512
768
512
1
6658
1
1
1
512
768
512
768
512
1
512
768
512
512
512
512
512
512
768
512
768
512
1
1
1
1
1
768
768
768
512
512
512
1
512
768
1
1
1
1
768
768
768
512
768
512
512
1
1
512
512
512
768
512
512
1
1
512
512
512
512
512
768
512
512
512
512
512
512
1
1
1
1
1
1
1
1
1
1
1
1
1
1
1
1
1
1
1
1
1
1
1
1
1
