1
1
1
1
1
1
1
1
1
1
1
1
1
1
1
1
1
1
1
1
1
1
1
1
1
1
512
512
512
512
3077
1
1
512
512
6663
768
512
512
512
768
512
512
768
515
1
1
1
1
512
768
3077
1
512
512
768
512
768
512
768
512
512
1
512
768
512
768
768
1
1
1
1
1
1
512
768
3077
768
768
768
512
1
1
512
512
1
768
768
768
768
512
1
1
6658
3077
1
1
512
768
768
768
512
768
512
1
1
1
512
768
512
512
512
768
512
1
1
768
512
768
3077
6664
768
512
512
768
768
768
512
3077
512
6664
768
768
512
768
768
512
1
1
512
768
768
768
768
768
768
512
768
512
768
768
768
512
768
768
3077
768
512
768
512
1
1
512
512
512
512
768
512
768
512
512
6663
768
512
768
512
512
768
512
512
512
512
512
1
1
1
1
1
1
1
1
1
1
1
1
1
1
1
1
1
1
1
1
1
1
1
1
