1
1
1
1
1
1
1
1
1
1
1
1
1
1
1
1
1
1
1
1
1
1
1
1
2564
2564
2564
2564
2564
1
2564
2564
1
2564
2564
2564
2564
2564
2564
2564
2564
2564
1
2564
2564
1
1
2564
2564
1
2564
2564
2564
2564
2564
2564
2564
2564
2564
1
2564
2564
2564
2564
2564
2564
2564
1
1
1
2564
2564
2564
2564
1
2564
2564
2564
2564
2564
2564
2564
2564
2564
2564
2564
2564
1
2564
2564
2564
1
1
2564
2564
2564
2564
2564
2564
2564
2564
2564
2564
1
2564
2564
2564
2564
1
2564
2564
2564
2564
2564
1
1
3077
1
2564
2564
2564
2564
2564
2564
768
2564
2564
768
2564
2564
768
2564
2564
768
2564
2564
2564
1
1
768
1
1
1
1
1
1
768
1
1
1
1
1
1
1
1
768
1
1
1
1
1
1
515
768
2564
2564
2564
2564
2564
3077
2564
2564
2564
2564
2564
2564
2564
2564
3077
2564
2564
3077
6658
1
1
1
1
1
1
1
1
1
1
1
1
1
1
1
1
1
1
1
1
1
1
1
1
