1
1
1
1
1
1
1
1
1
1
1
1
1
1
1
1
1
1
1
1
1
1
1
1
1
6664
768
512
512
1
512
512
512
512
512
512
512
6664
768
6664
512
768
512
3077
6663
1
1
1
512
3077
768
768
3077
768
6664
1
1
512
512
6664
768
512
768
512
768
768
768
768
1
1
1
512
512
3077
768
768
512
512
1
1
1
512
512
6664
768
6664
1
768
512
512
512
1
1
1
768
768
768
3077
768
512
768
1
1
1
768
768
768
1
768
512
512
512
768
512
1
1
1
768
6664
768
1
512
6663
512
512
768
512
768
512
768
512
768
768
768
768
768
768
1
1
1
512
768
3593
512
768
768
768
512
768
512
768
6664
768
3077
3077
512
512
512
6664
512
1
1
6658
3077
515
768
512
6664
512
512
512
768
512
768
512
512
512
1
1
512
768
512
512
1
1
1
1
1
1
1
1
1
1
1
1
1
1
1
1
1
1
1
1
1
1
1
1
