1
1
1
1
1
1
1
1
1
1
1
1
1
1
1
1
1
1
1
1
1
1
1
1
6663
3077
768
3077
1
1
512
512
768
3593
1
512
3077
768
512
1
1
1
512
1
1
1
1
768
512
768
768
768
512
1
512
768
512
1
512
768
512
512
1
6663
768
768
3077
6658
1
1
512
768
512
512
768
512
3077
3077
512
768
3077
768
768
768
512
1
1
1
512
1
768
1
1
512
768
1
1
1
1
1
1
1
512
1
512
768
3077
1
1
1
512
768
6664
512
1
1
512
512
512
768
3593
512
512
1
1
768
6664
1
1
3077
1
512
768
512
512
768
6664
1
1
768
768
512
768
512
768
768
3077
3077
512
768
512
768
512
768
512
768
768
3077
768
512
1
1
515
768
512
512
3593
6664
512
1
1
512
768
512
512
512
6664
768
3077
768
512
512
512
1
1
1
1
1
1
1
1
1
1
1
1
1
1
1
1
1
1
1
1
1
1
1
1
